host,clientIp,timestamp_min,timestamp_max,time_active,count
www.f81C.de,104.215.18.178,48295,286809,238514,4
www.f81C.de,110.193.215.48,189303,228127,38824,2
www.f81C.de,110.251.240.42,51088,51088,0,1
www.f81C.de,115.147.226.201,34296,104285,69989,6
www.f81C.de,115.239.140.6,225932,225932,0,1
www.f81C.de,118.45.72.40,42878,218826,175948,8
www.f81C.de,120.6.48.216,40880,255223,214343,5
www.f81C.de,122.164.48.164,31119,263515,232396,6
www.f81C.de,123.215.134.210,50191,297878,247687,4
www.f81C.de,127.199.221.38,25508,28981,3473,2
www.f81C.de,128.108.175.60,126141,228968,102827,4
www.f81C.de,13.181.79.103,40669,237024,196355,4
www.f81C.de,13.184.122.91,63459,190973,127514,5
www.f81C.de,137.207.159.71,2243,281038,278795,4
www.f81C.de,146.203.118.202,246130,246130,0,1
www.f81C.de,148.141.30.168,114313,114313,0,1
www.f81C.de,149.35.45.199,17122,260466,243344,3
www.f81C.de,152.129.18.101,150737,287235,136498,2
www.f81C.de,152.30.228.100,14127,147743,133616,2
www.f81C.de,153.73.103.169,8801,278409,269608,4
www.f81C.de,155.239.199.150,55174,219869,164695,3
www.f81C.de,157.77.114.252,165642,281799,116157,3
www.f81C.de,159.174.82.51,32547,234459,201912,3
www.f81C.de,160.51.209.132,144246,144246,0,1
www.f81C.de,161.22.185.25,118514,217342,98828,3
www.f81C.de,164.109.210.122,67400,246780,179380,3
www.f81C.de,166.115.64.61,2691,22674,19983,2
www.f81C.de,168.199.225.84,118760,265230,146470,3
www.f81C.de,169.205.127.190,1810,145596,143786,3
www.f81C.de,170.189.159.29,107363,107363,0,1
www.f81C.de,172.6.20.69,19557,295005,275448,8
www.f81C.de,174.188.216.99,52930,257117,204187,4
www.f81C.de,181.132.46.120,5469,276413,270944,3
www.f81C.de,181.224.77.220,11025,270492,259467,7
www.f81C.de,182.26.43.41,173928,176519,2591,2
www.f81C.de,183.98.21.192,149095,204122,55027,2
www.f81C.de,184.215.32.245,254946,297831,42885,2
www.f81C.de,190.38.172.213,145817,293639,147822,5
www.f81C.de,193.192.111.251,153201,153201,0,1
www.f81C.de,194.126.5.29,272660,272660,0,1
www.f81C.de,195.98.122.26,292203,292203,0,1
www.f81C.de,20.254.229.8,291918,291918,0,1
www.f81C.de,203.214.188.115,25444,170078,144634,2
www.f81C.de,218.145.250.80,239783,260499,20716,2
www.f81C.de,22.216.80.180,79354,101218,21864,2
www.f81C.de,22.33.218.14,156646,156646,0,1
www.f81C.de,220.54.39.55,38181,241852,203671,6
www.f81C.de,231.134.240.56,8096,286203,278107,8
www.f81C.de,236.69.110.201,252646,252646,0,1
www.f81C.de,239.241.137.232,33356,288269,254913,4
www.f81C.de,241.150.30.92,284451,284451,0,1
www.f81C.de,25.231.238.231,71266,281388,210122,6
www.f81C.de,250.93.165.7,80584,80584,0,1
www.f81C.de,251.32.53.21,45372,298909,253537,6
www.f81C.de,252.166.163.208,138728,299064,160336,3
www.f81C.de,28.31.79.222,14840,259152,244312,5
www.f81C.de,33.22.134.172,58369,299774,241405,5
www.f81C.de,34.77.119.65,280800,280800,0,1
www.f81C.de,37.182.70.216,7578,157105,149527,5
www.f81C.de,45.74.155.102,45698,151525,105827,2
www.f81C.de,46.172.18.85,34864,219067,184203,3
www.f81C.de,52.155.77.175,49362,286881,237519,3
www.f81C.de,53.253.230.134,6339,292393,286054,8
www.f81C.de,55.140.126.183,193135,240115,46980,2
www.f81C.de,58.235.39.81,216163,216163,0,1
www.f81C.de,65.251.192.36,151469,151469,0,1
www.f81C.de,73.72.187.106,61550,255026,193476,6
www.f81C.de,74.238.229.139,38224,61175,22951,2
www.f81C.de,76.50.66.38,60321,206522,146201,3
www.f81C.de,76.89.23.80,131579,155094,23515,2
www.f81C.de,78.129.91.226,28590,249151,220561,3
www.f81C.de,8.212.139.166,9476,199128,189652,4
www.f81C.de,91.17.14.243,74109,74361,252,2
www.f81C.de,95.249.153.156,52171,52171,0,1
www.f81C.de,97.172.166.199,144646,231067,86421,4
www.Ip8n.de,100.106.22.152,258944,258944,0,1
www.Ip8n.de,104.215.18.178,11132,199067,187935,6
www.Ip8n.de,110.193.215.48,28564,51927,23363,3
www.Ip8n.de,115.147.226.201,74835,260247,185412,3
www.Ip8n.de,115.239.140.6,18170,179356,161186,3
www.Ip8n.de,118.45.72.40,26052,150630,124578,4
www.Ip8n.de,120.6.48.216,41554,278852,237298,5
www.Ip8n.de,121.251.102.152,143704,288235,144531,3
www.Ip8n.de,122.164.48.164,135025,202335,67310,3
www.Ip8n.de,123.215.134.210,65841,198878,133037,6
www.Ip8n.de,124.225.243.14,130380,289952,159572,2
www.Ip8n.de,127.199.221.38,254140,254140,0,1
www.Ip8n.de,128.108.175.60,34431,269286,234855,5
www.Ip8n.de,13.181.79.103,31326,248639,217313,6
www.Ip8n.de,13.184.122.91,9653,224144,214491,4
www.Ip8n.de,131.27.209.217,6546,280017,273471,3
www.Ip8n.de,131.85.76.190,120371,187964,67593,2
www.Ip8n.de,137.147.206.112,69915,151299,81384,3
www.Ip8n.de,137.207.159.71,72989,72989,0,1
www.Ip8n.de,145.189.184.225,31203,31203,0,1
www.Ip8n.de,146.203.118.202,93944,93944,0,1
www.Ip8n.de,148.141.30.168,216448,290930,74482,2
www.Ip8n.de,149.35.45.199,153843,287115,133272,4
www.Ip8n.de,152.129.18.101,9365,265142,255777,8
www.Ip8n.de,152.30.228.100,129033,234241,105208,3
www.Ip8n.de,153.73.103.169,234506,234506,0,1
www.Ip8n.de,155.239.199.150,176739,218851,42112,2
www.Ip8n.de,159.174.82.51,99693,296421,196728,5
www.Ip8n.de,161.22.185.25,143235,284585,141350,7
www.Ip8n.de,164.109.210.122,6667,266738,260071,4
www.Ip8n.de,166.115.64.61,50009,239804,189795,3
www.Ip8n.de,168.199.225.84,116545,229940,113395,2
www.Ip8n.de,169.205.127.190,270373,270373,0,1
www.Ip8n.de,170.212.241.116,162527,162527,0,1
www.Ip8n.de,172.6.20.69,18416,175110,156694,3
www.Ip8n.de,174.188.216.99,95515,178101,82586,2
www.Ip8n.de,181.132.46.120,142488,278196,135708,2
www.Ip8n.de,181.224.77.220,51096,67126,16030,2
www.Ip8n.de,182.26.43.41,53570,182305,128735,2
www.Ip8n.de,183.98.21.192,113691,113691,0,1
www.Ip8n.de,184.215.32.245,177081,177081,0,1
www.Ip8n.de,190.38.172.213,55630,289539,233909,9
www.Ip8n.de,193.192.111.251,46654,299778,253124,4
www.Ip8n.de,194.120.60.174,6497,120224,113727,2
www.Ip8n.de,194.126.5.29,11766,90054,78288,3
www.Ip8n.de,195.98.122.26,154946,154946,0,1
www.Ip8n.de,203.214.188.115,22171,156212,134041,4
www.Ip8n.de,218.145.250.80,17437,244934,227497,9
www.Ip8n.de,22.216.80.180,30906,262595,231689,3
www.Ip8n.de,22.33.218.14,216864,216864,0,1
www.Ip8n.de,220.54.39.55,185479,269259,83780,2
www.Ip8n.de,224.105.171.19,94271,94271,0,1
www.Ip8n.de,231.134.240.56,144152,259689,115537,2
www.Ip8n.de,236.69.110.201,31009,202937,171928,2
www.Ip8n.de,238.51.146.163,70821,282716,211895,4
www.Ip8n.de,239.241.137.232,71675,175241,103566,3
www.Ip8n.de,241.150.30.92,25338,172692,147354,3
www.Ip8n.de,249.116.128.68,28717,220423,191706,4
www.Ip8n.de,25.231.238.231,8035,265278,257243,9
www.Ip8n.de,250.93.165.7,52326,229873,177547,3
www.Ip8n.de,251.32.53.21,44813,284779,239966,6
www.Ip8n.de,252.166.163.208,69570,212225,142655,3
www.Ip8n.de,28.31.79.222,173309,221920,48611,2
www.Ip8n.de,33.22.134.172,79640,204283,124643,4
www.Ip8n.de,34.77.119.65,48850,175189,126339,2
www.Ip8n.de,37.182.70.216,9051,206147,197096,4
www.Ip8n.de,45.74.155.102,93907,228271,134364,2
www.Ip8n.de,52.155.77.175,160535,160535,0,1
www.Ip8n.de,53.253.230.134,27561,282443,254882,6
www.Ip8n.de,55.140.126.183,12270,99581,87311,5
www.Ip8n.de,58.235.39.81,189462,189462,0,1
www.Ip8n.de,59.237.119.137,200338,200338,0,1
www.Ip8n.de,65.251.192.36,198160,198160,0,1
www.Ip8n.de,73.72.187.106,50409,142595,92186,3
www.Ip8n.de,74.238.229.139,147985,147985,0,1
www.Ip8n.de,76.50.66.38,87581,293700,206119,5
www.Ip8n.de,76.89.23.80,15259,15259,0,1
www.Ip8n.de,78.129.91.226,39511,175403,135892,3
www.Ip8n.de,8.212.139.166,296848,296848,0,1
www.Ip8n.de,91.17.14.243,31533,249713,218180,2
www.Ip8n.de,94.8.150.15,87437,164073,76636,4
www.Ip8n.de,95.83.162.166,6690,6690,0,1
www.Ip8n.de,97.172.166.199,71005,291137,220132,2
www.WN9V.de,104.215.18.178,140309,233445,93136,2
www.WN9V.de,110.193.215.48,196198,299630,103432,3
www.WN9V.de,110.251.240.42,291687,291687,0,1
www.WN9V.de,115.147.226.201,6240,283414,277174,4
www.WN9V.de,118.224.87.137,49930,193379,143449,2
www.WN9V.de,118.45.72.40,248390,258381,9991,2
www.WN9V.de,120.6.48.216,112884,215754,102870,3
www.WN9V.de,121.251.102.152,75529,192009,116480,6
www.WN9V.de,123.215.134.210,28996,215949,186953,4
www.WN9V.de,124.225.243.14,118242,118242,0,1
www.WN9V.de,127.199.221.38,287082,287082,0,1
www.WN9V.de,128.108.175.60,29385,285100,255715,5
www.WN9V.de,13.181.79.103,6724,262963,256239,11
www.WN9V.de,13.184.122.91,71695,244414,172719,8
www.WN9V.de,131.27.209.217,266780,276472,9692,2
www.WN9V.de,131.85.76.190,41047,243898,202851,4
www.WN9V.de,137.207.159.71,240448,240448,0,1
www.WN9V.de,146.203.118.202,118671,118671,0,1
www.WN9V.de,148.141.30.168,228974,286769,57795,2
www.WN9V.de,149.35.45.199,9417,95346,85929,3
www.WN9V.de,152.129.18.101,3409,277785,274376,4
www.WN9V.de,152.30.228.100,62667,206296,143629,4
www.WN9V.de,153.73.103.169,106801,192131,85330,4
www.WN9V.de,155.239.199.150,255508,297075,41567,2
www.WN9V.de,157.77.114.252,102415,241344,138929,2
www.WN9V.de,159.174.82.51,3961,99826,95865,3
www.WN9V.de,161.22.185.25,14956,167852,152896,4
www.WN9V.de,164.109.210.122,41118,292565,251447,2
www.WN9V.de,166.115.64.61,58633,297776,239143,4
www.WN9V.de,168.199.225.84,134706,152940,18234,2
www.WN9V.de,169.205.127.190,53097,114051,60954,2
www.WN9V.de,172.6.20.69,5327,289483,284156,8
www.WN9V.de,174.188.216.99,205932,205932,0,1
www.WN9V.de,181.132.46.120,63076,269427,206351,2
www.WN9V.de,181.224.77.220,280775,280775,0,1
www.WN9V.de,182.26.43.41,7082,205629,198547,3
www.WN9V.de,184.215.32.245,3576,10820,7244,2
www.WN9V.de,186.249.198.25,154312,154312,0,1
www.WN9V.de,193.192.111.251,73695,296054,222359,5
www.WN9V.de,194.120.60.174,15990,15990,0,1
www.WN9V.de,194.126.5.29,28563,290199,261636,4
www.WN9V.de,203.214.188.115,32288,232360,200072,2
www.WN9V.de,218.145.250.80,8975,262043,253068,6
www.WN9V.de,22.216.80.180,6865,156018,149153,4
www.WN9V.de,224.105.171.19,11410,11410,0,1
www.WN9V.de,231.134.240.56,27776,233983,206207,5
www.WN9V.de,236.69.110.201,5173,235161,229988,3
www.WN9V.de,239.241.137.232,275439,275439,0,1
www.WN9V.de,241.150.30.92,30854,122995,92141,4
www.WN9V.de,244.199.79.182,182293,263857,81564,2
www.WN9V.de,25.231.238.231,53372,231510,178138,6
www.WN9V.de,250.93.165.7,272045,272045,0,1
www.WN9V.de,251.32.53.21,87567,295937,208370,5
www.WN9V.de,252.166.163.208,62037,231587,169550,3
www.WN9V.de,28.31.79.222,19687,260580,240893,3
www.WN9V.de,33.22.134.172,8192,273695,265503,3
www.WN9V.de,33.91.83.246,32950,75605,42655,2
www.WN9V.de,34.77.119.65,79087,106512,27425,2
www.WN9V.de,37.153.143.129,97382,97382,0,1
www.WN9V.de,37.182.70.216,163202,262519,99317,2
www.WN9V.de,45.74.155.102,126273,212036,85763,3
www.WN9V.de,46.172.18.85,130846,259221,128375,3
www.WN9V.de,47.53.203.34,101228,285214,183986,2
www.WN9V.de,53.253.230.134,55105,274044,218939,3
www.WN9V.de,55.140.126.183,60895,114503,53608,3
www.WN9V.de,58.235.39.81,260606,266292,5686,2
www.WN9V.de,73.72.187.106,166640,264453,97813,3
www.WN9V.de,76.89.23.80,154078,154078,0,1
www.WN9V.de,78.129.91.226,77845,204008,126163,4
www.WN9V.de,8.212.139.166,34215,98056,63841,3
www.WN9V.de,91.17.14.243,40209,40209,0,1
www.WN9V.de,94.8.150.15,61495,300770,239275,3
www.WN9V.de,95.249.153.156,26719,259118,232399,4
www.WN9V.de,95.83.162.166,38393,223596,185203,5
www.WN9V.de,97.172.166.199,19646,231564,211918,4
www.J6Nj.de,104.215.18.178,70898,277033,206135,6
www.J6Nj.de,110.193.215.48,25028,63423,38395,3
www.J6Nj.de,115.147.226.201,23776,277583,253807,8
www.J6Nj.de,115.239.140.6,72299,72299,0,1
www.J6Nj.de,118.224.87.137,126794,126794,0,1
www.J6Nj.de,118.45.72.40,60760,171671,110911,2
www.J6Nj.de,120.6.48.216,25411,238650,213239,4
www.J6Nj.de,121.251.102.152,20177,257815,237638,7
www.J6Nj.de,122.164.48.164,20678,207456,186778,5
www.J6Nj.de,123.215.134.210,88403,278016,189613,3
www.J6Nj.de,127.199.221.38,14070,253044,238974,4
www.J6Nj.de,128.108.175.60,40087,252486,212399,3
www.J6Nj.de,13.181.79.103,1054,275020,273966,6
www.J6Nj.de,13.184.122.91,116639,241496,124857,2
www.J6Nj.de,131.27.209.217,69728,156957,87229,3
www.J6Nj.de,131.85.76.190,42474,246782,204308,4
www.J6Nj.de,137.147.206.112,111203,253532,142329,6
www.J6Nj.de,137.207.159.71,109390,300577,191187,4
www.J6Nj.de,146.203.118.202,283702,283702,0,1
www.J6Nj.de,148.141.30.168,153976,153976,0,1
www.J6Nj.de,149.35.45.199,107732,286274,178542,5
www.J6Nj.de,152.129.18.101,36187,291515,255328,4
www.J6Nj.de,152.30.228.100,89065,226302,137237,4
www.J6Nj.de,153.73.103.169,65200,196965,131765,3
www.J6Nj.de,155.239.199.150,84816,294171,209355,5
www.J6Nj.de,157.77.114.252,173961,173961,0,1
www.J6Nj.de,159.174.82.51,24516,250019,225503,4
www.J6Nj.de,161.22.185.25,271894,271894,0,1
www.J6Nj.de,164.109.210.122,128062,295649,167587,6
www.J6Nj.de,166.115.64.61,15127,251267,236140,4
www.J6Nj.de,168.199.225.84,245300,245300,0,1
www.J6Nj.de,169.205.127.190,295806,295806,0,1
www.J6Nj.de,172.6.20.69,101494,270420,168926,2
www.J6Nj.de,174.188.216.99,3817,150077,146260,4
www.J6Nj.de,181.132.46.120,4412,168133,163721,6
www.J6Nj.de,181.224.77.220,16211,122535,106324,3
www.J6Nj.de,182.26.43.41,7776,185751,177975,5
www.J6Nj.de,183.98.21.192,44821,199402,154581,4
www.J6Nj.de,184.215.32.245,162027,254850,92823,2
www.J6Nj.de,186.249.198.25,193635,193635,0,1
www.J6Nj.de,190.38.172.213,162869,263088,100219,3
www.J6Nj.de,193.192.111.251,138354,292131,153777,6
www.J6Nj.de,194.126.5.29,25732,131893,106161,4
www.J6Nj.de,195.98.122.26,38847,274866,236019,5
www.J6Nj.de,20.254.229.8,254936,254936,0,1
www.J6Nj.de,201.58.7.103,18950,18950,0,1
www.J6Nj.de,203.214.188.115,55863,102473,46610,3
www.J6Nj.de,218.145.250.80,15939,244073,228134,5
www.J6Nj.de,22.216.80.180,29737,278765,249028,7
www.J6Nj.de,22.33.218.14,116774,282951,166177,2
www.J6Nj.de,22.46.254.12,145502,226835,81333,2
www.J6Nj.de,220.54.39.55,76670,263384,186714,4
www.J6Nj.de,224.105.171.19,57781,300200,242419,2
www.J6Nj.de,231.134.240.56,36184,296989,260805,6
www.J6Nj.de,236.69.110.201,84010,134779,50769,2
www.J6Nj.de,238.51.146.163,2065,245575,243510,3
www.J6Nj.de,239.241.137.232,102328,297150,194822,3
www.J6Nj.de,241.150.30.92,16991,232228,215237,3
www.J6Nj.de,249.116.128.68,79700,251176,171476,3
www.J6Nj.de,25.231.238.231,5389,281611,276222,5
www.J6Nj.de,250.93.165.7,120400,120400,0,1
www.J6Nj.de,251.32.53.21,15312,229867,214555,6
www.J6Nj.de,252.166.163.208,273799,273799,0,1
www.J6Nj.de,28.31.79.222,14852,145441,130589,3
www.J6Nj.de,31.180.185.64,5042,5042,0,1
www.J6Nj.de,33.22.134.172,68357,217980,149623,3
www.J6Nj.de,33.91.83.246,42379,42379,0,1
www.J6Nj.de,37.153.143.129,282613,282613,0,1
www.J6Nj.de,37.182.70.216,74136,74136,0,1
www.J6Nj.de,45.74.155.102,155589,290201,134612,2
www.J6Nj.de,46.172.18.85,170070,170070,0,1
www.J6Nj.de,47.53.203.34,245028,254607,9579,2
www.J6Nj.de,53.253.230.134,280943,280943,0,1
www.J6Nj.de,55.140.126.183,91399,297433,206034,5
www.J6Nj.de,59.237.119.137,26567,26567,0,1
www.J6Nj.de,73.72.187.106,116873,300256,183383,4
www.J6Nj.de,74.238.229.139,168879,168879,0,1
www.J6Nj.de,76.50.66.38,57085,57085,0,1
www.J6Nj.de,78.129.91.226,13568,229422,215854,6
www.J6Nj.de,8.212.139.166,129287,255603,126316,3
www.J6Nj.de,91.17.14.243,92587,92587,0,1
www.J6Nj.de,94.8.150.15,76060,244865,168805,2
www.J6Nj.de,95.249.153.156,72044,218868,146824,2
www.J6Nj.de,95.83.162.166,14515,77924,63409,2
www.J6Nj.de,97.172.166.199,9090,265276,256186,6
www.NoE6.de,104.215.18.178,61574,297659,236085,4
www.NoE6.de,110.251.240.42,112705,112705,0,1
www.NoE6.de,115.147.226.201,64359,262775,198416,5
www.NoE6.de,115.239.140.6,73607,73607,0,1
www.NoE6.de,118.45.72.40,114150,299252,185102,3
www.NoE6.de,120.6.48.216,169539,235820,66281,2
www.NoE6.de,121.251.102.152,97871,254060,156189,3
www.NoE6.de,122.164.48.164,19183,169975,150792,4
www.NoE6.de,123.215.134.210,72682,260952,188270,6
www.NoE6.de,127.199.221.38,10611,10611,0,1
www.NoE6.de,13.181.79.103,30936,258392,227456,3
www.NoE6.de,13.184.122.91,8073,233499,225426,3
www.NoE6.de,131.27.209.217,119434,222741,103307,2
www.NoE6.de,131.85.76.190,76044,281444,205400,2
www.NoE6.de,137.147.206.112,19242,256139,236897,5
www.NoE6.de,137.207.159.71,127390,287212,159822,2
www.NoE6.de,146.203.118.202,10002,256014,246012,5
www.NoE6.de,148.141.30.168,8099,292789,284690,3
www.NoE6.de,149.35.45.199,5249,178881,173632,5
www.NoE6.de,152.129.18.101,145449,269110,123661,2
www.NoE6.de,152.30.228.100,107677,184037,76360,3
www.NoE6.de,153.73.103.169,43527,247460,203933,2
www.NoE6.de,155.239.199.150,14041,64874,50833,2
www.NoE6.de,157.77.114.252,2375,266620,264245,9
www.NoE6.de,159.174.82.51,9603,230974,221371,5
www.NoE6.de,161.22.185.25,51354,259732,208378,2
www.NoE6.de,164.109.210.122,36819,289024,252205,5
www.NoE6.de,166.115.64.61,24052,257023,232971,5
www.NoE6.de,168.199.225.84,1971,1971,0,1
www.NoE6.de,169.205.127.190,94931,241411,146480,4
www.NoE6.de,170.212.241.116,203388,203388,0,1
www.NoE6.de,172.6.20.69,75493,201014,125521,2
www.NoE6.de,174.188.216.99,45065,148450,103385,3
www.NoE6.de,181.132.46.120,173499,242523,69024,2
www.NoE6.de,181.224.77.220,52143,226199,174056,3
www.NoE6.de,182.26.43.41,9980,284668,274688,6
www.NoE6.de,183.98.21.192,143015,263788,120773,3
www.NoE6.de,184.215.32.245,26501,249752,223251,2
www.NoE6.de,186.249.198.25,255192,255192,0,1
www.NoE6.de,190.38.172.213,30821,163709,132888,2
www.NoE6.de,193.192.111.251,125770,238514,112744,3
www.NoE6.de,194.126.5.29,58344,225655,167311,3
www.NoE6.de,195.98.122.26,78443,230218,151775,5
www.NoE6.de,203.214.188.115,217825,268652,50827,2
www.NoE6.de,218.145.250.80,22853,243356,220503,6
www.NoE6.de,22.216.80.180,6927,111030,104103,3
www.NoE6.de,22.33.218.14,295627,295627,0,1
www.NoE6.de,22.46.254.12,7670,89364,81694,2
www.NoE6.de,220.54.39.55,175067,210197,35130,2
www.NoE6.de,224.105.171.19,258532,258532,0,1
www.NoE6.de,231.134.240.56,32535,242104,209569,4
www.NoE6.de,236.69.110.201,11755,184635,172880,4
www.NoE6.de,238.51.146.163,188057,263651,75594,3
www.NoE6.de,239.241.137.232,24956,24956,0,1
www.NoE6.de,241.150.30.92,12301,295149,282848,5
www.NoE6.de,249.116.128.68,264791,264791,0,1
www.NoE6.de,25.231.238.231,119589,268180,148591,4
www.NoE6.de,250.93.165.7,55451,255291,199840,4
www.NoE6.de,251.32.53.21,48937,149919,100982,3
www.NoE6.de,252.166.163.208,91212,248021,156809,4
www.NoE6.de,28.31.79.222,69762,260886,191124,6
www.NoE6.de,33.22.134.172,126932,203200,76268,2
www.NoE6.de,33.91.83.246,98107,98107,0,1
www.NoE6.de,34.77.119.65,110844,149819,38975,2
www.NoE6.de,37.182.70.216,8234,249249,241015,5
www.NoE6.de,45.74.155.102,176931,268787,91856,4
www.NoE6.de,46.172.18.85,182524,252840,70316,2
www.NoE6.de,53.253.230.134,194674,276214,81540,2
www.NoE6.de,55.140.126.183,85602,236276,150674,3
www.NoE6.de,65.251.192.36,70928,287813,216885,2
www.NoE6.de,73.72.187.106,47565,286051,238486,5
www.NoE6.de,74.238.229.139,27070,39133,12063,2
www.NoE6.de,76.89.23.80,27750,27750,0,1
www.NoE6.de,78.129.91.226,42361,141502,99141,4
www.NoE6.de,8.212.139.166,143964,265833,121869,4
www.NoE6.de,94.8.150.15,1579,242437,240858,4
www.NoE6.de,95.249.153.156,6689,163917,157228,3
www.NoE6.de,95.83.162.166,103702,258721,155019,3
www.NoE6.de,97.172.166.199,88211,214788,126577,3
www.qyEP.de,104.215.18.178,7489,247003,239514,8
www.qyEP.de,110.193.215.48,14408,169332,154924,4
www.qyEP.de,115.147.226.201,32790,289580,256790,6
www.qyEP.de,115.239.140.6,231985,259639,27654,2
www.qyEP.de,118.224.87.137,159221,159221,0,1
www.qyEP.de,118.45.72.40,18804,222300,203496,5
www.qyEP.de,120.6.48.216,6302,254953,248651,9
www.qyEP.de,121.251.102.152,123483,295903,172420,3
www.qyEP.de,122.164.48.164,209922,285376,75454,3
www.qyEP.de,123.215.134.210,185229,291887,106658,3
www.qyEP.de,124.225.243.14,80806,223050,142244,3
www.qyEP.de,127.199.221.38,21736,21736,0,1
www.qyEP.de,128.108.175.60,13160,286041,272881,9
www.qyEP.de,13.181.79.103,6352,221986,215634,4
www.qyEP.de,13.184.122.91,108694,294233,185539,7
www.qyEP.de,131.27.209.217,285557,297395,11838,2
www.qyEP.de,131.85.76.190,42865,274612,231747,4
www.qyEP.de,137.147.206.112,101625,236331,134706,3
www.qyEP.de,137.207.159.71,193541,271977,78436,3
www.qyEP.de,148.141.30.168,38853,215183,176330,3
www.qyEP.de,149.35.45.199,48851,285010,236159,6
www.qyEP.de,152.129.18.101,67827,74887,7060,2
www.qyEP.de,152.30.228.100,3442,193166,189724,6
www.qyEP.de,153.73.103.169,85180,263092,177912,6
www.qyEP.de,155.239.199.150,64799,120567,55768,2
www.qyEP.de,157.77.114.252,78930,151878,72948,2
www.qyEP.de,159.174.82.51,27268,271277,244009,7
www.qyEP.de,161.22.185.25,58476,286981,228505,3
www.qyEP.de,164.109.210.122,32500,266744,234244,3
www.qyEP.de,166.115.64.61,148039,242295,94256,3
www.qyEP.de,168.199.225.84,101246,293559,192313,3
www.qyEP.de,169.205.127.190,35068,252494,217426,2
www.qyEP.de,170.189.159.29,73460,255126,181666,3
www.qyEP.de,170.212.241.116,192475,242142,49667,2
www.qyEP.de,172.6.20.69,19176,272674,253498,5
www.qyEP.de,174.188.216.99,122619,122619,0,1
www.qyEP.de,181.132.46.120,156571,255810,99239,2
www.qyEP.de,181.224.77.220,175399,290795,115396,5
www.qyEP.de,182.26.43.41,115966,248141,132175,3
www.qyEP.de,183.98.21.192,119355,219731,100376,2
www.qyEP.de,184.215.32.245,4106,4106,0,1
www.qyEP.de,186.249.198.25,284682,284682,0,1
www.qyEP.de,190.38.172.213,137113,292872,155759,5
www.qyEP.de,193.192.111.251,34087,241321,207234,6
www.qyEP.de,194.120.60.174,180653,180653,0,1
www.qyEP.de,194.126.5.29,59852,225952,166100,3
www.qyEP.de,195.98.122.26,111848,111848,0,1
www.qyEP.de,203.214.188.115,154764,185706,30942,3
www.qyEP.de,22.216.80.180,118638,162298,43660,5
www.qyEP.de,220.54.39.55,61163,279140,217977,4
www.qyEP.de,224.105.171.19,126424,126424,0,1
www.qyEP.de,231.134.240.56,56371,198444,142073,5
www.qyEP.de,236.69.110.201,5140,214483,209343,2
www.qyEP.de,238.51.146.163,103175,199672,96497,3
www.qyEP.de,239.241.137.232,7569,262214,254645,7
www.qyEP.de,241.150.30.92,27967,219996,192029,5
www.qyEP.de,244.199.79.182,134963,134963,0,1
www.qyEP.de,249.116.128.68,187896,225629,37733,2
www.qyEP.de,25.231.238.231,31537,273599,242062,7
www.qyEP.de,250.93.165.7,15731,171334,155603,2
www.qyEP.de,251.32.53.21,9344,291760,282416,8
www.qyEP.de,252.166.163.208,11695,295566,283871,5
www.qyEP.de,28.31.79.222,20071,287081,267010,5
www.qyEP.de,33.22.134.172,69491,282369,212878,5
www.qyEP.de,33.91.83.246,150969,261882,110913,2
www.qyEP.de,34.77.119.65,121366,250588,129222,3
www.qyEP.de,37.182.70.216,60785,143081,82296,2
www.qyEP.de,45.74.155.102,2942,276148,273206,3
www.qyEP.de,46.172.18.85,71550,257367,185817,2
www.qyEP.de,47.53.203.34,67940,121987,54047,2
www.qyEP.de,52.155.77.175,211619,249894,38275,2
www.qyEP.de,53.253.230.134,12804,298331,285527,8
www.qyEP.de,55.140.126.183,45928,273264,227336,4
www.qyEP.de,58.235.39.81,1864,1864,0,1
www.qyEP.de,73.72.187.106,11101,293713,282612,7
www.qyEP.de,76.89.23.80,188483,188483,0,1
www.qyEP.de,78.129.91.226,206510,300364,93854,3
www.qyEP.de,8.212.139.166,54389,185449,131060,4
www.qyEP.de,9.226.118.66,32033,32033,0,1
www.qyEP.de,91.17.14.243,12259,12259,0,1
www.qyEP.de,94.8.150.15,47657,113355,65698,2
www.qyEP.de,95.249.153.156,210518,210518,0,1
www.qyEP.de,95.83.162.166,71963,76791,4828,2
www.qyEP.de,97.172.166.199,211025,234622,23597,2
www.xOTw.de,104.215.18.178,106739,300002,193263,4
www.xOTw.de,110.193.215.48,295822,295822,0,1
www.xOTw.de,115.147.226.201,209072,209072,0,1
www.xOTw.de,115.239.140.6,208668,232493,23825,2
www.xOTw.de,118.224.87.137,63978,266393,202415,3
www.xOTw.de,118.45.72.40,47631,191513,143882,4
www.xOTw.de,120.6.48.216,3562,290559,286997,4
www.xOTw.de,121.251.102.152,34737,204122,169385,3
www.xOTw.de,122.164.48.164,100165,294998,194833,3
www.xOTw.de,123.215.134.210,17448,251493,234045,2
www.xOTw.de,124.225.243.14,178568,178568,0,1
www.xOTw.de,127.199.221.38,240445,285814,45369,3
www.xOTw.de,128.108.175.60,27225,270262,243037,9
www.xOTw.de,13.181.79.103,9397,119728,110331,4
www.xOTw.de,13.184.122.91,284577,284577,0,1
www.xOTw.de,131.27.209.217,72909,225456,152547,2
www.xOTw.de,131.85.76.190,193704,269865,76161,2
www.xOTw.de,137.147.206.112,145908,283397,137489,4
www.xOTw.de,137.207.159.71,173175,211156,37981,2
www.xOTw.de,146.203.118.202,58576,58576,0,1
www.xOTw.de,148.141.30.168,128593,128593,0,1
www.xOTw.de,149.35.45.199,239247,251909,12662,2
www.xOTw.de,152.129.18.101,30556,126692,96136,3
www.xOTw.de,152.30.228.100,45917,277864,231947,4
www.xOTw.de,153.73.103.169,143594,186657,43063,4
www.xOTw.de,155.239.199.150,7798,171583,163785,7
www.xOTw.de,157.77.114.252,54589,168578,113989,2
www.xOTw.de,159.174.82.51,63889,277365,213476,5
www.xOTw.de,161.22.185.25,114754,193924,79170,2
www.xOTw.de,164.109.210.122,60280,234280,174000,2
www.xOTw.de,166.115.64.61,37984,220864,182880,3
www.xOTw.de,168.199.225.84,185201,231138,45937,2
www.xOTw.de,169.205.127.190,205491,205491,0,1
www.xOTw.de,172.6.20.69,18600,170986,152386,5
www.xOTw.de,174.188.216.99,132477,296063,163586,4
www.xOTw.de,181.132.46.120,54650,216602,161952,3
www.xOTw.de,181.224.77.220,57167,91826,34659,2
www.xOTw.de,183.98.21.192,150776,254909,104133,5
www.xOTw.de,184.215.32.245,252350,252350,0,1
www.xOTw.de,186.249.198.25,42664,42664,0,1
www.xOTw.de,190.38.172.213,87071,238737,151666,3
www.xOTw.de,193.192.111.251,23579,206855,183276,4
www.xOTw.de,194.126.5.29,38428,283864,245436,3
www.xOTw.de,195.98.122.26,130107,130107,0,1
www.xOTw.de,203.214.188.115,22149,25906,3757,2
www.xOTw.de,218.145.250.80,24727,267531,242804,8
www.xOTw.de,22.216.80.180,133506,199701,66195,3
www.xOTw.de,22.33.218.14,19346,19346,0,1
www.xOTw.de,22.46.254.12,116379,116379,0,1
www.xOTw.de,220.54.39.55,6742,248631,241889,5
www.xOTw.de,224.105.171.19,165310,165310,0,1
www.xOTw.de,231.134.240.56,28717,283247,254530,3
www.xOTw.de,236.69.110.201,84685,142449,57764,4
www.xOTw.de,238.51.146.163,116664,298365,181701,3
www.xOTw.de,239.241.137.232,42588,252078,209490,4
www.xOTw.de,241.150.30.92,169285,169285,0,1
www.xOTw.de,249.116.128.68,168706,219595,50889,2
www.xOTw.de,25.231.238.231,199758,220951,21193,2
www.xOTw.de,250.93.165.7,57893,57893,0,1
www.xOTw.de,251.32.53.21,185717,185717,0,1
www.xOTw.de,252.166.163.208,43624,262548,218924,7
www.xOTw.de,28.31.79.222,43334,263682,220348,6
www.xOTw.de,31.180.185.64,55207,126488,71281,2
www.xOTw.de,33.22.134.172,11261,184220,172959,9
www.xOTw.de,33.91.83.246,49179,49179,0,1
www.xOTw.de,34.77.119.65,99546,99546,0,1
www.xOTw.de,37.153.143.129,108038,108038,0,1
www.xOTw.de,37.182.70.216,217795,262785,44990,3
www.xOTw.de,45.74.155.102,38441,274205,235764,3
www.xOTw.de,46.172.18.85,2831,2831,0,1
www.xOTw.de,52.155.77.175,6331,96832,90501,2
www.xOTw.de,53.253.230.134,15462,257958,242496,8
www.xOTw.de,55.140.126.183,84420,84420,0,1
www.xOTw.de,73.72.187.106,55893,300488,244595,6
www.xOTw.de,74.238.229.139,134685,134685,0,1
www.xOTw.de,76.50.66.38,113959,245642,131683,2
www.xOTw.de,76.89.23.80,134252,163516,29264,2
www.xOTw.de,78.129.91.226,4109,289159,285050,4
www.xOTw.de,8.212.139.166,68014,219888,151874,2
www.xOTw.de,94.8.150.15,36748,36748,0,1
www.xOTw.de,95.249.153.156,21073,283326,262253,3
www.xOTw.de,97.172.166.199,10225,199225,189000,6
www.CLFs.de,100.106.22.152,297957,297957,0,1
www.CLFs.de,104.215.18.178,22728,266396,243668,2
www.CLFs.de,110.193.215.48,62620,276936,214316,7
www.CLFs.de,110.251.240.42,3960,178127,174167,2
www.CLFs.de,115.147.226.201,95119,202450,107331,5
www.CLFs.de,118.224.87.137,178935,254846,75911,2
www.CLFs.de,118.45.72.40,4954,245109,240155,6
www.CLFs.de,120.6.48.216,17100,299310,282210,8
www.CLFs.de,121.251.102.152,90784,164605,73821,2
www.CLFs.de,122.164.48.164,121984,279484,157500,3
www.CLFs.de,123.215.134.210,76980,235910,158930,3
www.CLFs.de,128.108.175.60,64474,250187,185713,6
www.CLFs.de,13.181.79.103,7374,206267,198893,4
www.CLFs.de,13.184.122.91,46833,285979,239146,4
www.CLFs.de,131.27.209.217,294611,294611,0,1
www.CLFs.de,131.85.76.190,162081,251583,89502,2
www.CLFs.de,137.147.206.112,22713,293794,271081,3
www.CLFs.de,137.207.159.71,155198,293947,138749,3
www.CLFs.de,146.203.118.202,7018,270436,263418,2
www.CLFs.de,148.141.30.168,41076,141197,100121,4
www.CLFs.de,149.35.45.199,81212,299772,218560,3
www.CLFs.de,152.129.18.101,146321,181865,35544,3
www.CLFs.de,152.30.228.100,84568,114309,29741,2
www.CLFs.de,153.73.103.169,10837,274824,263987,4
www.CLFs.de,155.239.199.150,36550,244763,208213,5
www.CLFs.de,157.77.114.252,74908,150386,75478,4
www.CLFs.de,159.174.82.51,155906,290825,134919,5
www.CLFs.de,161.22.185.25,127902,259216,131314,3
www.CLFs.de,164.109.210.122,5237,283683,278446,4
www.CLFs.de,166.115.64.61,119906,119906,0,1
www.CLFs.de,168.199.225.84,15960,225899,209939,6
www.CLFs.de,169.205.127.190,112353,112353,0,1
www.CLFs.de,170.212.241.116,146689,146689,0,1
www.CLFs.de,172.6.20.69,265881,265881,0,1
www.CLFs.de,181.132.46.120,23586,283680,260094,9
www.CLFs.de,181.224.77.220,26340,242088,215748,3
www.CLFs.de,182.26.43.41,118002,118002,0,1
www.CLFs.de,183.98.21.192,79750,186797,107047,4
www.CLFs.de,184.215.32.245,59619,63164,3545,2
www.CLFs.de,190.38.172.213,89284,246600,157316,3
www.CLFs.de,193.192.111.251,149007,149007,0,1
www.CLFs.de,194.126.5.29,135461,297479,162018,5
www.CLFs.de,195.98.122.26,71792,71792,0,1
www.CLFs.de,203.214.188.115,74089,74089,0,1
www.CLFs.de,218.145.250.80,24667,249653,224986,5
www.CLFs.de,22.216.80.180,278901,278901,0,1
www.CLFs.de,22.33.218.14,159203,159203,0,1
www.CLFs.de,22.46.254.12,172298,203699,31401,2
www.CLFs.de,220.54.39.55,74569,193384,118815,3
www.CLFs.de,224.105.171.19,56713,164890,108177,2
www.CLFs.de,231.134.240.56,214756,214756,0,1
www.CLFs.de,236.69.110.201,59785,208841,149056,3
www.CLFs.de,238.51.146.163,184642,258848,74206,2
www.CLFs.de,239.241.137.232,233279,258752,25473,2
www.CLFs.de,241.150.30.92,292903,292903,0,1
www.CLFs.de,249.116.128.68,144178,216471,72293,3
www.CLFs.de,25.231.238.231,27946,162993,135047,3
www.CLFs.de,250.93.165.7,119327,119327,0,1
www.CLFs.de,251.32.53.21,43606,279904,236298,6
www.CLFs.de,252.166.163.208,58857,263109,204252,4
www.CLFs.de,28.31.79.222,14482,197935,183453,5
www.CLFs.de,33.22.134.172,63782,299142,235360,5
www.CLFs.de,33.91.83.246,28890,152123,123233,3
www.CLFs.de,34.77.119.65,66435,296756,230321,4
www.CLFs.de,37.153.143.129,41039,41039,0,1
www.CLFs.de,37.182.70.216,276379,276379,0,1
www.CLFs.de,45.74.155.102,8910,140545,131635,5
www.CLFs.de,52.155.77.175,3548,3548,0,1
www.CLFs.de,53.253.230.134,102608,219696,117088,4
www.CLFs.de,55.140.126.183,60907,296199,235292,2
www.CLFs.de,58.235.39.81,266677,266677,0,1
www.CLFs.de,65.251.192.36,135411,149515,14104,2
www.CLFs.de,73.72.187.106,20381,292655,272274,2
www.CLFs.de,74.238.229.139,260369,288339,27970,2
www.CLFs.de,76.50.66.38,45378,45378,0,1
www.CLFs.de,76.89.23.80,265730,265730,0,1
www.CLFs.de,78.129.91.226,84768,241172,156404,2
www.CLFs.de,8.212.139.166,8218,249831,241613,5
www.CLFs.de,9.226.118.66,283029,283029,0,1
www.CLFs.de,91.17.14.243,255069,255069,0,1
www.CLFs.de,94.8.150.15,77705,83376,5671,2
www.CLFs.de,95.249.153.156,51550,295229,243679,4
www.CLFs.de,95.83.162.166,29472,256403,226931,4
www.CLFs.de,97.172.166.199,71201,282699,211498,5
www.UDsx.de,100.106.22.152,276541,276541,0,1
www.UDsx.de,104.215.18.178,24229,237231,213002,3
www.UDsx.de,110.193.215.48,62779,260202,197423,3
www.UDsx.de,115.147.226.201,16588,220915,204327,6
www.UDsx.de,118.224.87.137,50093,96785,46692,2
www.UDsx.de,118.45.72.40,24625,271297,246672,4
www.UDsx.de,120.6.48.216,71576,71576,0,1
www.UDsx.de,121.251.102.152,131068,251513,120445,3
www.UDsx.de,122.164.48.164,39901,231342,191441,4
www.UDsx.de,123.215.134.210,3003,239495,236492,5
www.UDsx.de,127.199.221.38,2913,205748,202835,5
www.UDsx.de,128.108.175.60,208264,208264,0,1
www.UDsx.de,13.181.79.103,32358,226848,194490,5
www.UDsx.de,13.184.122.91,103802,249414,145612,4
www.UDsx.de,131.27.209.217,197331,197331,0,1
www.UDsx.de,131.85.76.190,86974,185298,98324,2
www.UDsx.de,137.147.206.112,143934,297908,153974,5
www.UDsx.de,137.207.159.71,32348,114651,82303,2
www.UDsx.de,148.141.30.168,281736,281736,0,1
www.UDsx.de,149.35.45.199,195113,200180,5067,2
www.UDsx.de,152.129.18.101,134880,274644,139764,3
www.UDsx.de,152.30.228.100,109046,286481,177435,2
www.UDsx.de,153.73.103.169,16894,185384,168490,4
www.UDsx.de,155.239.199.150,25131,177782,152651,7
www.UDsx.de,157.77.114.252,31746,167984,136238,5
www.UDsx.de,159.174.82.51,37113,279862,242749,4
www.UDsx.de,161.22.185.25,87148,263946,176798,5
www.UDsx.de,164.109.210.122,4561,244471,239910,7
www.UDsx.de,166.115.64.61,39032,192564,153532,3
www.UDsx.de,168.199.225.84,290468,290468,0,1
www.UDsx.de,169.205.127.190,126866,270268,143402,3
www.UDsx.de,170.212.241.116,300577,300577,0,1
www.UDsx.de,174.188.216.99,25296,184169,158873,4
www.UDsx.de,181.132.46.120,76416,299413,222997,5
www.UDsx.de,181.224.77.220,34959,232991,198032,2
www.UDsx.de,182.26.43.41,170900,256065,85165,2
www.UDsx.de,183.98.21.192,29397,251268,221871,5
www.UDsx.de,184.215.32.245,163224,286782,123558,2
www.UDsx.de,190.38.172.213,5047,283604,278557,8
www.UDsx.de,193.192.111.251,14916,221372,206456,4
www.UDsx.de,194.126.5.29,12656,277243,264587,2
www.UDsx.de,195.98.122.26,118949,297614,178665,4
www.UDsx.de,203.214.188.115,235247,262878,27631,2
www.UDsx.de,218.145.250.80,65456,65456,0,1
www.UDsx.de,22.216.80.180,12490,289954,277464,4
www.UDsx.de,22.46.254.12,238228,238228,0,1
www.UDsx.de,220.54.39.55,3782,186909,183127,4
www.UDsx.de,224.105.171.19,92656,205580,112924,2
www.UDsx.de,231.134.240.56,107505,221330,113825,4
www.UDsx.de,236.69.110.201,44159,276646,232487,2
www.UDsx.de,238.51.146.163,10414,219746,209332,2
www.UDsx.de,239.241.137.232,45243,45243,0,1
www.UDsx.de,241.150.30.92,43751,192732,148981,2
www.UDsx.de,249.116.128.68,190031,190031,0,1
www.UDsx.de,25.231.238.231,6084,276544,270460,4
www.UDsx.de,251.32.53.21,154228,277675,123447,4
www.UDsx.de,252.166.163.208,71080,233525,162445,4
www.UDsx.de,28.31.79.222,24290,294188,269898,5
www.UDsx.de,33.22.134.172,1159,276759,275600,8
www.UDsx.de,33.91.83.246,61441,235353,173912,4
www.UDsx.de,34.77.119.65,26962,248599,221637,3
www.UDsx.de,37.182.70.216,51134,256946,205812,4
www.UDsx.de,45.74.155.102,37779,79693,41914,2
www.UDsx.de,46.172.18.85,96286,260266,163980,2
www.UDsx.de,47.53.203.34,297361,297361,0,1
www.UDsx.de,52.155.77.175,293610,293610,0,1
www.UDsx.de,53.253.230.134,200694,298759,98065,3
www.UDsx.de,55.140.126.183,31203,168617,137414,3
www.UDsx.de,58.235.39.81,25814,26163,349,2
www.UDsx.de,73.72.187.106,53140,258822,205682,4
www.UDsx.de,74.238.229.139,201304,201304,0,1
www.UDsx.de,76.89.23.80,79430,191128,111698,3
www.UDsx.de,78.129.91.226,2213,294422,292209,3
www.UDsx.de,8.212.139.166,30177,54361,24184,2
www.UDsx.de,91.17.14.243,67256,250355,183099,2
www.UDsx.de,94.8.150.15,40246,280677,240431,4
www.UDsx.de,95.249.153.156,105379,259055,153676,3
www.UDsx.de,95.83.162.166,66888,66888,0,1
www.UDsx.de,97.172.166.199,81978,273865,191887,3
www.44LC.de,104.215.18.178,222930,296976,74046,2
www.44LC.de,110.193.215.48,76454,79991,3537,2
www.44LC.de,115.147.226.201,71950,289585,217635,5
www.44LC.de,118.224.87.137,39498,83293,43795,3
www.44LC.de,118.45.72.40,88624,237586,148962,7
www.44LC.de,120.6.48.216,24416,273349,248933,7
www.44LC.de,121.251.102.152,125375,125375,0,1
www.44LC.de,122.164.48.164,101979,210377,108398,3
www.44LC.de,123.215.134.210,72693,279384,206691,6
www.44LC.de,127.199.221.38,294555,294555,0,1
www.44LC.de,128.108.175.60,5053,230458,225405,7
www.44LC.de,13.181.79.103,20628,112418,91790,3
www.44LC.de,13.184.122.91,93481,299507,206026,4
www.44LC.de,131.27.209.217,48654,264645,215991,3
www.44LC.de,131.85.76.190,205538,255431,49893,3
www.44LC.de,137.147.206.112,268176,268176,0,1
www.44LC.de,137.207.159.71,232593,248671,16078,2
www.44LC.de,146.203.118.202,5896,242385,236489,3
www.44LC.de,148.141.30.168,53264,92705,39441,2
www.44LC.de,149.35.45.199,30660,206670,176010,3
www.44LC.de,152.129.18.101,86234,300475,214241,5
www.44LC.de,153.73.103.169,55720,229597,173877,4
www.44LC.de,155.239.199.150,4136,211530,207394,2
www.44LC.de,157.77.114.252,28117,286818,258701,3
www.44LC.de,159.174.82.51,24985,199613,174628,3
www.44LC.de,161.22.185.25,28165,207373,179208,5
www.44LC.de,164.109.210.122,40281,293672,253391,4
www.44LC.de,166.115.64.61,88159,253563,165404,4
www.44LC.de,168.199.225.84,43091,89577,46486,2
www.44LC.de,169.205.127.190,34218,287992,253774,9
www.44LC.de,170.189.159.29,236465,236465,0,1
www.44LC.de,172.6.20.69,137388,137388,0,1
www.44LC.de,174.188.216.99,42122,210871,168749,3
www.44LC.de,181.132.46.120,159578,245809,86231,4
www.44LC.de,181.224.77.220,131575,299329,167754,7
www.44LC.de,182.26.43.41,24147,194544,170397,2
www.44LC.de,183.98.21.192,90326,198085,107759,3
www.44LC.de,184.215.32.245,132820,132820,0,1
www.44LC.de,186.249.198.25,75511,75511,0,1
www.44LC.de,190.38.172.213,127505,249133,121628,2
www.44LC.de,195.98.122.26,30971,30971,0,1
www.44LC.de,203.214.188.115,136945,136945,0,1
www.44LC.de,218.145.250.80,54428,279315,224887,4
www.44LC.de,22.216.80.180,102673,194779,92106,3
www.44LC.de,22.33.218.14,136067,136067,0,1
www.44LC.de,224.105.171.19,75403,216671,141268,5
www.44LC.de,231.134.240.56,42230,278607,236377,3
www.44LC.de,236.69.110.201,35616,234848,199232,4
www.44LC.de,238.51.146.163,141637,149637,8000,2
www.44LC.de,239.241.137.232,10711,275836,265125,6
www.44LC.de,241.150.30.92,85593,85593,0,1
www.44LC.de,249.116.128.68,42332,259164,216832,2
www.44LC.de,25.231.238.231,72589,287278,214689,4
www.44LC.de,251.32.53.21,34072,251331,217259,5
www.44LC.de,252.166.163.208,90305,205145,114840,2
www.44LC.de,28.31.79.222,83291,83291,0,1
www.44LC.de,33.22.134.172,6061,200125,194064,6
www.44LC.de,33.91.83.246,42344,253375,211031,4
www.44LC.de,34.77.119.65,57134,270203,213069,3
www.44LC.de,37.182.70.216,94212,253250,159038,5
www.44LC.de,45.74.155.102,2156,286922,284766,5
www.44LC.de,46.172.18.85,30885,117585,86700,2
www.44LC.de,52.155.77.175,38910,114270,75360,2
www.44LC.de,53.253.230.134,32181,245061,212880,5
www.44LC.de,55.140.126.183,14882,262428,247546,3
www.44LC.de,58.235.39.81,215496,215496,0,1
www.44LC.de,59.237.119.137,193903,193903,0,1
www.44LC.de,73.72.187.106,152349,152349,0,1
www.44LC.de,74.238.229.139,300937,300937,0,1
www.44LC.de,76.50.66.38,47367,106432,59065,2
www.44LC.de,76.89.23.80,75594,75594,0,1
www.44LC.de,78.129.91.226,85839,85839,0,1
www.44LC.de,8.212.139.166,119351,233164,113813,7
www.44LC.de,9.226.118.66,42034,42034,0,1
www.44LC.de,91.17.14.243,190826,285847,95021,6
www.44LC.de,94.8.150.15,179197,179197,0,1
www.44LC.de,95.249.153.156,154050,299993,145943,3
www.44LC.de,95.83.162.166,68890,126486,57596,2
www.44LC.de,97.172.166.199,44581,275759,231178,3
